----- ----- ----- ----- ----- ----- ----- ----- ----- ----- ----- ----- ----- ----- ----- ----- ----- ----- ----- ----- ----- ----- ----- ----- ----- ----- ----- -----
----- ----- ----- ----- ----- ----- ----- ----- ----- ----- ----- ----- ----- ----- ----- ----- ----- ----- ----- ----- ----- ----- ----- ----- ----- ----- ----- -----
----- ----- ----- ----- ----- ----- ----- ----- ----- ----- ----- ----- ----- ----- ----- ----- ----- ----- ----- ----- ----- ----- ----- ----- ----- ----- ----- -----
----- ----- ----- ----- ----- ----- ----- ----- ----- ----- ----- ----- ----- ----- ----- ----- ----- ----- ----- ----- ----- ----- ----- ----- ----- ----- ----- -----
----- ----- ----- ----- ----- ----- ----- ----- ----- ----- ----- ----- ----- ----- ----- ----- ----- ----- ----- ----- ----- ----- ----- ----- ----- ----- ----- -----
----- ----- ----- ----- ----- ----- ----- ----- ----- ----- ----- ----- ----- ----- ----- ----- ----- ----- ----- ----- ----- ----- ----- ----- ----- ----- ----- -----
----- ----- ----- ----- ----- ----- ----- ----- ----- ----- ----- ----- ----- ----- ----- ----- ----- ----- ----- ----- ----- ----- ----- ----- ----- ----- ----- -----
----- ----- ----- ----- ----- ----- ----- ----- ----- ----- ----- ----- ----- ----- ----- ----- ----- ----- ----- ----- ----- ----- ----- ----- ----- ----- ----- -----
----- ----- ----- ----- ----- ----- ----- ----- ----- ----- ----- ----- ----- ----- ----- ----- ----- ----- ----- ----- ----- ----- ----- ----- ----- ----- ----- -----
----- ----- ----- ----- ----- ----- ----- ----- ----- ----- ----- ----- ----- ----- ----- ----- ----- ----- ----- ----- ----- ----- ----- ----- ----- ----- ----- -----
----- ----- ----- ----- ----- ----- ----- ----- ----- ----- ----- FL|NP BR|NP SW|CR BR|NP FL|NP ----- ----- ----- ----- ----- ----- ----- ----- ----- ----- ----- -----
----- ----- ----- ----- ----- FL|NP OS|CR ----- ----- ----- ----- FL|NP LWALL LWALL LWALL FL|NP ----- ----- ----- ----- OS|CR FL|NP ----- ----- ----- ----- ----- -----
----- ----- ----- ----- ----- FL|NP LWALL ----- LWALL ----- LWALL FL|NP LWALL FL|CR LWALL FL|NP LWALL ----- LWALL ----- LWALL FL|NP ----- ----- ----- ----- ----- -----
----- ----- ----- ----- ----- FL|NP OW|NP ----- ----- ----- ----- FL|NP LWALL FL|NP LWALL FL|NP ----- ----- ----- ----- ----- FL|NP ----- ----- ----- ----- ----- -----
----- ----- ----- ----- ----- FL|NP FL|NP FL|NP FL|NP FL|NP FL|NP FL|NP FL|NP FL|DR FL|NP FL|NP FL|NP FL|NP FL|NP FL|NP FL|NP FL|NP ----- ----- ----- ----- ----- ----- ----- ----- ----- ----- ----- ----- ----- ----- ----- ----- ----- ----- -----
----- ----- ----- ----- FL|NP FL|NP ----- ----- ----- ----- ----- ----- ----- FL|NP ----- ----- ----- ----- ----- ----- ----- FL|NP CS|NP ----- ----- ----- ----- -----
----- ----- ----- LWALL ----- FL|NP ----- MWALL MWALL MWALL MWALL MWALL MWALL FL|SP MWALL MWALL MWALL MWALL MWALL MWALL ----- FL|NP ----- ----- ----- ----- -----
----- FL|NP FL|BH FL|NP OW|NP FL|NP ----- MWALL SP|NP SP|NP SP|NP SP|NP SP|NP SP|NP SP|NP SP|NP SP|NP SP|NP SP|NP MWALL ----- FL|NP ----- ----- ----- ----- ----- -----
----- FL|NP LWALL FL|NP ----- FL|NP FL|NP MWALL SP|NP MWALL MWALL MWALL MWALL LWALL MWALL MWALL MWALL MWALL SP|NP MWALL CS|NP FL|NP ----- SP|CR ----- ----- FL|CR ----- -----
----- FL|NP FL|NP FL|NP ----- FL|NP ----- MWALL SP|NP MWALL SP|NP SP|NP SP|NP SP|NP SP|NP SP|NP SP|NP MWALL SP|NP MWALL ----- FL|NP ----- SP|SP ----- ----- FL|NP ----- -----
----- LWALL FL|NP LWALL FL|NP FL|NP ----- MWALL SP|NP MWALL SP|NP MWALL MWALL FL|NP MWALL MWALL SP|NP MWALL SP|NP MWALL ----- FL|NP ----- SP|NP ----- OB|NP FL|NP OB|CR -----
----- FL|NP FL|CR FL|NP ----- FL|NP ----- MWALL SP|NP MWALL SP|NP MWALL FL|NP FL|NP FL|NP MWALL SP|NP MWALL SP|NP MWALL ----- FL|NP ----- SP|NP ----- FL|NP FL|NP FL|NP -----
----- FL|CM MWALL FL|CM CS|CR FL|CM ----- MWALL SP|NP FL|SP SP|NP MWALL FL|NP BS|NP FL|NP MWALL SP|NP FL|NP SP|NP MWALL ----- FL|NP OS|NP SP|NP ----- FL|NP ----- FL|NP -----
----- FL|NP MWALL FL|NP CS|CR FL|NP ----- MWALL SP|NP MWALL SP|NP MWALL FL|NP FL|NP FL|NP MWALL SP|SP MWALL SP|NP MWALL ----- FL|NP ----- SP|NP ----- FL|DR ----- FL|DR -----
----- FL|NP FL|CR FL|NP ----- FL|NP ----- MWALL SP|NP MWALL SP|NP MWALL MWALL FL|CR MWALL MWALL SP|NP MWALL SP|NP MWALL ----- FL|NP ----- SP|NP ----- FL|NP FL|NP FL|NP -----
----- LWALL FL|NP LWALL FL|NP FL|NP ----- MWALL SP|NP MWALL SP|NP SP|NP SP|NP SP|NP SP|NP SP|NP SP|NP MWALL SP|NP MWALL ----- FL|NP ----- SP|NP ----- OB|NP FL|NP OB|NP -----
----- FL|NP FL|NP FL|NP ----- FL|NP ----- MWALL SP|NP MWALL MWALL MWALL MWALL MWALL MWALL MWALL MWALL MWALL SP|NP MWALL ----- FL|NP ----- SP|NP ----- ----- FL|NP ----- -----
----- FL|NP LWALL FL|NP ----- FL|NP FL|NP MWALL SP|NP SP|NP SP|NP SP|NP SP|NP SP|NP SP|NP SP|NP SP|NP SP|NP SP|NP MWALL CS|NP FL|NP ----- SP|NP ----- ----- FL|NP ----- -----
----- FL|NP FL|NP FL|NP OW|NP FL|NP ----- MWALL MWALL MWALL MWALL MWALL MWALL FL|SP MWALL MWALL MWALL MWALL MWALL MWALL ----- FL|NP ----- SP|NP OS|NP FL|NP FL|NP -----
----- ----- ----- LWALL FL|NP FL|NP ----- ----- ----- ----- ----- ----- ----- FL|NP ----- ----- ----- ----- ----- ----- ----- FL|NP CS|NP SP|NP CS|BP FL|NP ----- -----
----- ----- ----- ----- ----- FL|NP FL|NP FL|NP FL|NP FL|NP FL|NP FL|NP FL|NP FL|NP FL|NP FL|NP FL|CM FL|NP FL|NP FL|NP FL|NP FL|NP ----- SP|NP ----- FL|NP ----- ----- ----- ----- ----- ----- ----- ----- ----- ----- ----- ----- ----- -----
----- ----- ----- ----- ----- FL|NP ----- ----- ----- ----- ----- ----- ----- CS|NP ----- ----- ----- ----- ----- ----- OW|NP FL|NP ----- ----- ----- FL|NP ----- -----
----- ----- ----- ----- ----- FL|NP LWALL ----- LWALL ----- LWALL ----- BR|DR BR|CM BR|DR ----- LWALL ----- LWALL ----- LWALL FL|NP ----- ----- ----- FL|NP ----- -----
----- ----- ----- ----- ----- FL|NP FL|BH ----- ----- ----- ----- ----- ----- BR|CR ----- ----- ----- ----- ----- ----- FL|NP FL|NP ----- ----- ----- FL|NP ----- -----
----- ----- ----- ----- ----- ----- ----- ----- ----- ----- ----- ----- ----- ----- ----- ----- ----- ----- ----- ----- ----- ----- ----- ----- ----- FL|NP ----- -----
----- ----- ----- ----- ----- ----- ----- ----- ----- ----- ----- ----- ----- ----- ----- ----- ----- ----- ----- ----- ----- ----- ----- ----- ----- FL|NP ----- -----
----- ----- ----- ----- ----- ----- ----- ----- ----- ----- ----- ----- ----- ----- ----- ----- ----- ----- ----- ----- ----- ----- ----- ----- ----- FL|NP ----- -----
----- ----- ----- ----- ----- ----- ----- ----- ----- ----- ----- ----- ----- ----- ----- ----- ----- ----- ----- ----- ----- ----- ----- ----- ----- FL|NP ----- -----
----- ----- ----- ----- ----- ----- ----- ----- ----- ----- ----- ----- ----- ----- ----- ----- ----- ----- ----- ----- ----- FL|TO FL|NP FL|NP FL|NP OB|NP FL|CR -----
----- ----- ----- ----- ----- ----- ----- ----- ----- ----- ----- ----- ----- ----- ----- ----- ----- ----- ----- ----- ----- ----- ----- ----- ----- ----- ----- -----
----- ----- ----- ----- ----- ----- ----- ----- ----- ----- ----- ----- ----- ----- ----- ----- ----- ----- ----- ----- ----- ----- ----- ----- ----- ----- ----- -----
----- ----- ----- ----- ----- ----- ----- ----- ----- ----- ----- ----- ----- ----- ----- ----- ----- ----- ----- ----- ----- ----- ----- ----- ----- ----- ----- -----
----- ----- ----- ----- ----- ----- ----- ----- ----- ----- ----- ----- ----- ----- ----- ----- ----- ----- ----- ----- ----- ----- ----- ----- ----- ----- ----- -----
----- ----- ----- ----- ----- ----- ----- ----- ----- ----- ----- ----- ----- ----- ----- ----- ----- ----- ----- ----- ----- ----- ----- ----- ----- ----- ----- -----
----- ----- ----- ----- ----- ----- ----- ----- ----- ----- ----- ----- ----- ----- ----- ----- ----- ----- ----- ----- ----- ----- ----- ----- ----- ----- ----- -----
----- ----- ----- ----- ----- ----- ----- ----- ----- ----- ----- ----- ----- ----- ----- ----- ----- ----- ----- ----- ----- ----- ----- ----- ----- ----- ----- -----
----- ----- ----- ----- ----- ----- ----- ----- ----- ----- ----- ----- ----- ----- ----- ----- ----- ----- ----- ----- ----- ----- ----- ----- ----- ----- ----- -----
----- ----- ----- ----- ----- ----- ----- ----- ----- ----- ----- ----- ----- ----- ----- ----- ----- ----- ----- ----- ----- ----- ----- ----- ----- ----- ----- -----
----- ----- ----- ----- ----- ----- ----- ----- ----- ----- ----- ----- ----- ----- ----- ----- ----- ----- ----- ----- ----- ----- ----- ----- ----- ----- ----- -----